cirkulirati	irati
cirkulisati	isati
amortizirati	irati
amortizovati	ovati
debitirati	irati
debitovati	ovati
informirati	irati
informisati	isati
nivelirati	irati
nivelisati	isati
formalizirati	irati
formalizovati	ovati
bojkotirati	irati
bojkotovati	ovati
transferirati	irati
transferisati	isati
materijalizirati	irati
materijalizovati	ovati
interesirati	irati
interesovati	ovati
akcentirati	irati
akcentovati	ovati
destimulirati	irati
destimulisati	isati
defilirati	irati
defilovati	ovati
instrumentalizirati	irati
instrumentalizovati	ovati
dirigirati	irati
dirigovati	ovati
klimatizirati	irati
klimatizovati	ovati
iskontrolirati	irati
iskontrolisati	isati
dokumentirati	irati
dokumentovati	ovati
izmanipulirati	irati
izmanipulisati	isati
recitirati	irati
recitovati	ovati
lobirati	irati
lobovati	ovati
legalizirati	irati
legalizovati	ovati
penzionirati	irati
penzionisati	isati
banalizirati	irati
banalizovati	ovati
prepakirati	irati
prepakovati	ovati
digitalizirati	irati
digitalizovati	ovati
prepirati	irati
prepisati	isati
kompromitirati	irati
kompromitovati	ovati
definirati	irati
definisati	isati
iskombinirati	irati
iskombinovati	ovati
privatizirati	irati
privatizovati	ovati
upakirati	irati
upakovati	ovati
funkcionirati	irati
funkcionisati	isati
rezonirati	irati
rezonovati	ovati
sankcionirati	irati
sankcionisati	isati
konkurirati	irati
konkurisati	isati
odreagirati	irati
odreagovati	ovati
destilirati	irati
destilovati	ovati
prodiskutirati	irati
prodiskutovati	ovati
reafirmirati	irati
reafirmisati	isati
improvizirati	irati
improvizovati	ovati
transportirati	irati
transportovati	ovati
dokapitalizirati	irati
dokapitalizovati	ovati
integrirati	irati
integrisati	isati
idealizirati	irati
idealizovati	ovati
intervenirati	irati
intervenisati	isati
determinirati	irati
determinisati	isati
revitalizirati	irati
revitalizovati	ovati
selektirati	irati
selektovati	ovati
generirati	irati
generisati	isati
artikulirati	irati
artikulisati	isati
deponirati	irati
deponovati	ovati
zapakirati	irati
zapakovati	ovati
kampirati	irati
kampovati	ovati
korigirati	irati
korigovati	ovati
deportirati	irati
deportovati	ovati
reagirati	irati
reagovati	ovati
generalizirati	irati
generalizovati	ovati
sistematizirati	irati
sistematizovati	ovati
orijentirati	irati
orijentisati	isati
reflektirati	irati
reflektovati	ovati
demokratizirati	irati
demokratizovati	ovati
formulirati	irati
formulisati	isati
respektirati	irati
respektovati	ovati
tagirati	irati
tagovati	ovati
problematizirati	irati
problematizovati	ovati
cenzurirati	irati
cenzurisati	isati
prodefilirati	irati
prodefilovati	ovati
banirati	irati
banovati	ovati
nominirati	irati
nominovati	ovati
kompenzirati	irati
kompenzovati	ovati
manevrirati	irati
manevrisati	isati
popularizirati	irati
popularizovati	ovati
personalizirati	irati
personalizovati	ovati
manipulirati	irati
manipulisati	isati
prekontrolirati	irati
prekontrolisati	isati
zagarantirati	irati
zagarantovati	ovati
profilirati	irati
profilisati	isati
protestirati	irati
protestovati	ovati
dekoncentrirati	irati
dekoncentrisati	isati
fotografirati	irati
fotografisati	isati
kondenzirati	irati
kondenzovati	ovati
dopirati	irati
dopisati	isati
editirati	irati
editovati	ovati
internacionalizirati	irati
internacionalizovati	ovati
pakirati	irati
pakovati	ovati
favorizirati	irati
favorizovati	ovati
civilizirati	irati
civilizovati	ovati
resetirati	irati
resetovati	ovati
dezavuirati	irati
dezavuisati	isati
spakirati	irati
spakovati	ovati
detektirati	irati
detektovati	ovati
globalizirati	irati
globalizovati	ovati
fakturirati	irati
fakturisati	isati
institucionalizirati	irati
institucionalizovati	ovati
skoncentrirati	irati
skoncentrisati	isati
garantirati	irati
garantovati	ovati
projektirati	irati
projektovati	ovati
dešifrirati	irati
dešifrovati	ovati
desifrirati	irati
desifrovati	ovati
kriminalizirati	irati
kriminalizovati	ovati
inaugurirati	irati
inaugurisati	isati
preformulirati	irati
preformulisati	isati
dramatizirati	irati
dramatizovati	ovati
sugerirati	irati
sugerisati	isati
tolerirati	irati
tolerisati	isati
decentralizirati	irati
decentralizovati	ovati
deformirati	irati
deformisati	isati
ukomponirati	irati
ukomponovati	ovati
stimulirati	irati
stimulisati	isati
rehabilitirati	irati
rehabilitovati	ovati
standardizirati	irati
standardizovati	ovati
konvertirati	irati
konvertovati	ovati
reorganizirati	irati
reorganizovati	ovati
operirati	irati
operisati	isati
organizirati	irati
organizovati	ovati
emancipirati	irati
emancipovati	ovati
pretendirati	irati
pretendovati	ovati
regenerirati	irati
regenerisati	isati
liberalizirati	irati
liberalizovati	ovati
dezinformirati	irati
dezinformisati	isati
diskriminirati	irati
diskriminisati	isati
bombardirati	irati
bombardovati	ovati
registrirati	irati
registrovati	ovati
paralizirati	irati
paralizovati	ovati
socijalizirati	irati
socijalizovati	ovati
normalizirati	irati
normalizovati	ovati
memorirati	irati
memorisati	isati
šifrirati	irati
šifrovati	ovati
sifrirati	irati
sifrovati	ovati
sponzorirati	irati
sponzorisati	isati
proklamirati	irati
proklamovati	ovati
debatirati	irati
debatovati	ovati
lokalizirati	irati
lokalizovati	ovati
izolirati	irati
izolovati	ovati
optimizirati	irati
optimizovati	ovati
eliminirati	irati
eliminisati	isati
tematizirati	irati
tematizovati	ovati
reprezentirati	irati
reprezentovati	ovati
kandidirati	irati
kandidovati	ovati
nacionalizirati	irati
nacionalizovati	ovati
konkretizirati	irati
konkretizovati	ovati
prodirati	irati
prodisati	isati
prekomandirati	irati
prekomandovati	ovati
evakuirati	irati
evakuisati	isati
promovirati	irati
promovisati	isati
trijumfirati	irati
trijumfovati	ovati
preorijentirati	irati
preorijentisati	isati
atakirati	irati
atakovati	ovati
ispirati	irati
ispisati	isati
suspendirati	irati
suspendovati	ovati
komandirati	irati
komandovati	ovati
kultivirati	irati
kultivisati	isati
motivirati	irati
motivisati	isati
konfigurirati	irati
konfigurisati	isati
realizirati	irati
realizovati	ovati
regulirati	irati
regulisati	isati
grupirati	irati
grupisati	isati
rezultirati	irati
rezultovati	ovati
radikalizirati	irati
radikalizovati	ovati
kontrahirati	irati
kontrahovati	ovati
komponirati	irati
komponovati	ovati
dezorijentirati	irati
dezorijentisati	isati
minimizirati	irati
minimizovati	ovati
nadirati	irati
nadisati	isati
manifestirati	irati
manifestovati	ovati
valorizirati	irati
valorizovati	ovati
angažirati	irati
angažovati	ovati
angazirati	irati
angazovati	ovati
demilitarizirati	irati
demilitarizovati	ovati
autorizirati	irati
autorizovati	ovati
minimalizirati	irati
minimalizovati	ovati
diskutirati	irati
diskutovati	ovati
kapitalizirati	irati
kapitalizovati	ovati
harmonizirati	irati
harmonizovati	ovati
dekonstruirati	irati
dekonstruisati	isati
imponirati	irati
imponovati	ovati
intervjuirati	irati
intervjuisati	isati
eksperimentirati	irati
eksperimentisati	isati
kanonizirati	irati
kanonizovati	ovati
racionalizirati	irati
racionalizovati	ovati
spekulirati	irati
spekulisati	isati
destabilizirati	irati
destabilizovati	ovati
kontrolirati	irati
kontrolisati	isati
remontirati	irati
remontovati	ovati
redefinirati	irati
redefinisati	isati
individualizirati	irati
individualizovati	ovati
ignorirati	irati
ignorisati	isati
stabilizirati	irati
stabilizovati	ovati
finalizirati	irati
finalizovati	ovati
relativizirati	irati
relativizovati	ovati
stilizirati	irati
stilizovati	ovati
ludirati	irati
ludovati	ovati
marginalizirati	irati
marginalizovati	ovati
subvencionirati	irati
subvencionisati	isati
deklarirati	irati
deklarisati	isati
transformirati	irati
transformisati	isati
rezervirati	irati
rezervisati	isati
neutralizirati	irati
neutralizovati	ovati
kombinirati	irati
kombinovati	ovati
regrutirati	irati
regrutovati	ovati
operacionalizirati	irati
operacionalizovati	ovati
samoorganizirati	irati
samoorganizovati	ovati
zainteresirati	irati
zainteresovati	ovati
konstatirati	irati
konstatovati	ovati
opstruirati	irati
opstruisati	isati
resorbirati	irati
resorbovati	ovati
eksproprirati	irati
eksproprisati	isati
kalkulirati	irati
kalkulisati	isati
profunkcionirati	irati
profunkcionisati	isati
negirati	irati
negovati	ovati
asimilirati	irati
asimilovati	ovati
legitimirati	irati
legitimisati	isati
specijalizirati	irati
specijalizovati	ovati
apsorbirati	irati
apsorbovati	ovati
privilegirati	irati
privilegovati	ovati
emitirati	irati
emitovati	ovati
referirati	irati
referisati	isati
inkriminirati	irati
inkriminisati	isati
konsolidirati	irati
konsolidovati	ovati
demantirati	irati
demantovati	ovati
akreditirati	irati
akreditovati	ovati
hospitalizirati	irati
hospitalizovati	ovati
demotivirati	irati
demotivisati	isati
centralizirati	irati
centralizovati	ovati
afirmirati	irati
afirmisati	isati
reformirati	irati
reformisati	isati
koncentrirati	irati
koncentrisati	isati
argumentirati	irati
argumentovati	ovati
eksploatirati	irati
eksploatisati	isati
konstruirati	irati
konstruisati	isati
transponirati	irati
transponovati	ovati
homogenizirati	irati
homogenizovati	ovati
automatizirati	irati
automatizovati	ovati
koordinirati	irati
koordinisati	isati
inspirirati	irati
inspirisati	isati
ilustrirati	irati
ilustrovati	ovati
kidnapirati	irati
kidnapovati	ovati
modernizirati	irati
modernizovati	ovati
prezentirati	irati
prezentovati	ovati
apelirati	irati
apelovati	ovati
konektirati	irati
konektovati	ovati
ulogirati	irati
ulogovati	ovati
disciplinirati	irati
disciplinovati	ovati
simbolizirati	irati
simbolizovati	ovati
dekorirati	irati
dekorisati	isati
konstituirati	irati
konstituisati	isati
špekulirati	irati
špekulisati	isati
politizirati	irati
politizovati	ovati
diskreditirati	irati
diskreditovati	ovati
rekonstruirati	irati
rekonstruisati	isati
